..A######
q....#...
.#####.q.
.#......#
.<.......
.##^#.q..
#...#....
...#####.
.q.....B.