..q.q....
qA....q..
.#.....q.
.#.##....
.##..###w
q.>.##.<q
..#.<.q#.
..###q.Bq
.q.......