.q..q..q.
.A#####..
.#q.#..#.
q...#q.#q
.#^##.##.
.#..#.q#.
q#.....#q
.##vB###.
....q.q..