....q....
.q.....q.
..A###...
..#q.#q..
..#.###..
q.###.#.q
....##B..
..q....q.
.....q...