.q..w....
.A#####q.
.#w.#..#.
q...#w.#w
.#^##..#.
.#..#.q#.
w#.....#w
.##vB###.
....q.w..