....q....
#qA....q.
..#..q...
q.###...q
..#.#v#q.
.#..q.<.q
q##...#.#
..##B##..
...q...q.