....q....
#wA....w.
..#..q...
w.###...q
..#.#v#r.
.#..q.<.w
q##...#.#
..##B##..
...w...q.