....w....
wAq...q..
.#..#..w.
.#w#..#..
.##.####w
q.>.#..<.
..#.<.q#.
.w###..Bq
..q..w.w.