..#.....q
q....A...
.#####.q.
.#......#
.#.......
.#^v#.q..
#...#....
...####B.
.q.......