1##########.
##..#.....##
#...#......#
#...########
#...A..B...#
########...#
#......#...#
##.....#..##
.##########.