....q....
...qAq...
....#....
..#####..
..>.q.<..
.###.###.
.#.#.#.#.
.@.@.B.@.
.........