.........
...#A#...
.q.#.#.q.
...###...
.B..#..@.
.#..<..#.
.<..#..<.
.#######.
.........