....q....
...qAq...
....#....
..#####..
..>.q.<..
.###.###.
.#.#.#.#.
.@.B.@.@.
.........