1q.....q.
qA##.....
.q.#.q...
..##....q
..<......
..#..###.
..##v#.#.
......qBq
q......q.