q.......q
...##B...
..##.....
..#..A...
..>..#...
..#..##..
..##..#..
...#v##..
q.......q