q.......q
..#A.....
.##...q..
.#.q.....
.>.....B.
.#...q.#.
.##...##.
..##^##..
q.......q