4...q....
...qAq...
....#....
..#####..
..>.q.<..
.###.###.
.#.#.#.#.
qB.B.B.Bq
.q..q..q.