1.......q
q.###Bq..
..#......
.##.q....
.>..A#...
.#...##..
.###..#..
...#v##..
q.......q