1.......q
..#A.....
.##...q..
.#.q.....
.>.......
.#...q.B.
.##...##.
..##^##..
q.......q