1...........
.....q......
............
.....##v#...
.....>..#...
....##..#...
.q..#...B...
....A.....q.
............