1...........
.....q......
......q.....
..A.........
..##...##B..
...##..#....
....#^v#....
.q.......q..
............