1...........
............
....A##..q..
.q....#.....
....#v#.....
...##......q
...>.#B.....
...###......
............