1....q......
............
.....#v##...
....##..>...
...##..##...
...#...#...q
...A...B....
............
.q..........