1...........
..A..q......
..#.........
..##........
...#v#...q..
.....#^#....
..q....##B..
............
............