............
.........q..
......q.....
.wq......B.q
.....#v#.#..
q.A#.#.#^#..
...###......
........q...
............