............
.........qw.
..........q.
.A###...q...
....#v#.....
......#^#...
.q..q...##B.
.wq.........
............