............
..q.....q...
....##A.wq..
...##.......
q..#..B#....
.q.#...<.q..
...##v##....
............
.....q...q..