............
..q.........
.qw.A##.q...
......#..q..
....#v#...q.
...##.......
...>..#B.wq.
...####..q..
............