............
............
.....#v###..
.q.A.#...#..
w..#.#@#.#..
...#...#.B.q
.q.###v#....
.........q.w
............