............
............
..qwq.###...
......#.#.q.
...B#.A.#...
.q..#...#..q
.qw.#v#^#...
............
.....q.q....