............
............
..qwq.A##...
........#.q.
...B#.w.#...
....#...#..q
.qw.#v#^#...
............
............