............
..q......qw.
...........q
.A##....q...
...##v#...q.
......#^#...
.q..q...##B.
.wq.........
...........q