............
............
....qwq..q..
.....q......
.A##...##B.q
...##..>....
.q..#^##.qw.
.wq.........
............