............
.....q......
....qwq..q..
..A..q......
..##...##B.q
...##..>....
.q..#^##.qw.
.wq.........
............