............
........q...
............
...q.####.q.
.....>..<...
....##..#...
.qw.#...B...
..q.A.....q.
.........q..