.........q..
............
.....#v##B.w
..q..#......
...q.#@#.q..
.......#..q.
.w.A##v#....
............
...q........