1........
.........
.........
......B..
......#..
..A.###..
..###....
.........
.........