1........
.........
..A......
..#......
..#......
..###....
....##B..
.........
.........