1........
.........
...A.....
..##.B#..
..#...#..
..#..##..
..##v#...
.........
.........