1........
.........
..####...
..#..<...
..#..##..
..A...#..
....B##..
.........
.........