1.#......
.....A...
.#####...
.#......#
.#.......
.#^##....
#...<....
...####B.
.........