4........
....A....
....#....
..#####..
..>.q.<..
.###.###.
.#.#.#.#.
.B.B.B.B.
.........