1........
..###B...
..#......
.##......
.>..A#...
.#...##..
.###..#..
...#v##..
.........