1........
.........
..##v##..
..#...#..
..#...#..
..#.A.B..
..###....
.........
.........