1........
.......#.
....A....
....#....
....##...
..#..<...
.....#...
.....B...
.......#.