1........
.........
....A....
...###...
...#.#...
...###...
....B....
.........
.........