1........
.........
..A......
..##.....
...##....
....##...
.....#B..
.........
.........