1........
.........
.........
A.....###
#.##v##.#
###.....B
.........
.........
.........