1........
.........
.........
..A.###..
..#.#.#..
..###.B..
.........
.........
.........