2........
.........
...#A#...
...#.#...
...###...
....<....
.B#####B.
.........
.........