1........
..#A.....
.##......
.#.......
.>.......
.#.....B.
.##...##.
..##^##..
.........