q........
...q.....
.q....q..
.....qBq.
..q...#..
.qAq###..
..###...q
q........
.....q...