.........
....q....
...qAq...
....#....
..#####..
..#...#..
.qBq.q@q.
..q...q..
.........