.........
..q...q..
.qAq...q.
..#..q...
..#......
.q###.q..
.qq.##Bq.
......q..
q........