q........
....q....
.q.......
..A.###..
..#.#.#..
..###.B..
....q....
.......q.
...q.....