.....q...
.qq.....q
.qA...q..
..##.....
...##....
....##...
.....#Bq.
q.....qq.
..q......