.........
....q....
...qAq...
.q.###.q.
.q.#.#.q.
.q.###.q.
...qBq...
....q....
.........