2........
....q....
...qAq...
....#....
..#####..
..#...#..
.qBq.qBq.
..q...q..
.........