1...........
.......q....
...A........
...#......q.
...##.......
....####B...
............
..q.........
............