1...........
.........q..
...A........
...##.......
....###.....
......##B...
..........q.
..q.........
............