1...........
........q...
..q.........
............
...###......
...#.##B....
...#........
...A...q....
............