............
...q...q....
..qw........
......###...
..A##.#.#..q
....###.B...
..q.........
....qwq...q.
............