............
...q........
..q.....q...
....##A.wq..
....#.......
....##.B....
.....###....
..qw.....q..
...q....q...