............
.......qwq..
........q...
....###.....
..q.#.##B.q.
..w.#.......
....###.q...
......A.....
....q...w...