............
......q.....
...A.qwq....
.q.#........
...##.###...
....###.#.q.
........B...
....qwq.....
.....q......