.q..........
q...........
...##A..q...
...#...qwq..
...###......
.....##B....
..qw.......q
...q........
........q...