............
............
...A..qwq...
...#...q....
...###......
.....###...q
..qw...##B..
...q........
........q..w