............
.......qwq..
........q...
....###.....
..q.#.##B...
..w.#.......
....###A.q..
............
.......q.w..