............
.......q....
.....A.wq...
.....#......
.....####...
...q....#...
..qwq.B##...
...q........
............