............
............
...A..qwq...
...#...q....
...###......
.....###B..q
..qw........
...q........
........q..w