.q........qw
q..........q
....####....
....#..#....
....#A.#....
.......#....
....#B##....
q..........q
wq........q.