1........
.q.....q.
..##v##..
..#...#..
..#.q.#..
..#.A.B..
..###....
.q.....q.
.........