.........
...qqq...
...#A#.q.
.q.#.#...
...###...
.q..<..q.
qB#####@q
.q.....q.
.........