1.....q..
.q.......
..####.q.
..#..<...
..#..##..
..Aq..#..
....B##.q
.q.......
....q....