1...q....
.q....q..
.........
A..q.q###
#.##v##.#
###q.q..B
.........
..q....q.
.....q...