2........
....q....
...#A#.q.
.q.#.#...
...###...
.q..<..q.
qB#####Bq
.q.....q.
.........