.........
...qqq...
...#A#.q.
.q.#.#...
...###...
.q..<..q.
q@#####Bq
.q.....q.
.........