1q.....q.
.....q...
q..A....q
..##.B#..
..#...#..
..#..##..
.q##v#q..
.qq.....q
.....q...