1...........
......q.....
.........q..
..A..q......
..#....B....
..##...#....
...##^##....
............
............