1...........
....A....q..
....#..q....
....#.......
...##....q..
...>........
...##.......
....##B.....
............