1...........
............
....####....
...A#..##...
........>...
...q..B##...
............
.q...q......
............