1...........
........q...
....A..q....
....#....q..
...##.......
...#.##B....
...#^#......
............
............