1...........
............
....####....
....>..#....
...##..#B...
...A........
........q...
....q....q..
............