............
.........q..
.....###....
...A##.##...
........>...
...q..###...
..qwq.#.....
...q..B.q...
............