............
......q.....
............
.wq.##v#.q..
.q..#..#....
...##..#B...
...A......q.
.........qw.
............