............
.q..........
......w.....
...A.q......
...#..q.B.q.
...##...#.w.
....##^##.q.
..q.........
............