............
....q.......
...qw.A#....
.......#.wq.
....####....
..q.>.......
....###B.q..
............
.....q......