............
..q..A......
.qw..##.....
......#..wq.
....###..q..
..q.>.......
....##......
.....##B.q..
............