............
.q.....B....
....q..#....
...qw.##..q.
......>.....
....###.q...
....#....w..
..q.A.q.....
............