............
............
...A..q.q...
.q.#.qw.....
.w.#....B.q.
...##..##...
....##v#....
............
......q.....