............
........w...
..q.A..q....
.w..#....q..
...##.......
...#..##B...
...##^#.....
........q...
.....q......